0~999999981777
1~999999981992
2~999999981768
3~999999981406
4~999999981971
5~999999996218
6~999999981776
7~999999996209
8~999999981732
9~999999981978
10~999999981856
11~999999981451
12~999999981411
13~999999981452
14~999999981489
15~999999981675
16~999999981524
17~999999996201
18~999999981990
19~999999981587
20~999999981858
21~999999981681
22~999999981416
23~999999981526
24~999999981401
25~999999981516
26~999999996212
27~999999981849
28~999999981808
29~999999981691
30~999999996236
31~999999981500
32~999999981684
33~999999981586
34~999999981780
35~999999981427
36~999999981446
37~999999981445
38~999999996221
39~999999981415
40~999999981523
41~999999981773
42~999999981442
43~999999981993
44~999999981589
45~999999981775
46~999999981772
47~999999981404
48~999999981433
49~999999981829
50~999999981477
51~999999981407
52~999999981495
53~999999981521
54~999999981494
55~999999981592
56~999999981843
57~999999981590
58~999999981700
59~999999981420
60~999999981437
61~999999981398
62~999999981976
63~999999981757
64~999999981980
65~999999981555
66~999999981552
67~999999981491
68~999999981580
69~999999996200
70~999999981588
71~999999981522
72~999999981493
73~999999996213
74~999999981585
75~999999981536
76~999999981995
77~999999996229
78~999999981584
79~999999981988
80~999999996215
81~999999981412
82~999999981996
83~999999981417
84~999999981550
85~999999981405
86~999999981861
87~999999981479
88~999999981572
89~999999996226
90~999999996224
91~999999981845
92~999999981478
93~999999981448
94~999999981430
95~999999981475
96~999999981577
97~999999981573
98~999999981865
99~999999981432
100~999999981759
101~999999981414
102~999999981781
103~999999981532
104~999999981982
105~999999981534
106~999999981596
107~999999981409
108~999999981549
109~999999981575
110~999999981443
111~999999981439
112~999999996214
113~999999996233
114~999999981515
115~999999981440
116~999999981481
117~999999981436
118~999999981497
119~999999981543
120~999999981498
121~999999996206
122~999999981728
123~999999981574
124~999999981779
125~999999981421
126~999999981399
127~999999981674
128~999999981803
129~999999981419
130~999999981496
131~999999981434
132~999999981758
133~999999981535
134~999999981403
135~999999981683
136~999999981486
137~999999981570
138~999999981696
139~999999981488
140~999999981423
141~999999996238
142~999999981544
143~999999981984
144~999999981545
145~999999981531
146~999999981553
147~999999981441
148~999999981410
149~999999981533
150~999999996230
151~999999996227
152~999999996235
153~999999981560
154~999999996225
155~999999981767
156~999999981562
157~999999996216
158~999999981424
159~999999981766
160~999999981402
161~999999981557
162~999999981529
163~999999981413
164~999999981408
165~999999981546
166~999999981701
167~999999981563
168~999999981426
169~999999981537
170~999999981490
171~999999981869
172~999999981418
173~999999981859
174~999999981583
175~999999981576
176~999999981985
177~999999981998
178~999999981518
179~999999981852
180~999999981987
181~999999981997
182~999999981539
183~999999981485
184~999999981989
185~999999981551
186~999999981567
187~999999981986
188~999999981492
189~999999981425
190~999999981422
191~999999981828
192~999999981499
193~999999981694
194~999999981548
195~999999981806
196~999999981981
197~999999981689
198~999999981983
199~999999981397
200~999999981541
201~999999981484
202~999999981449
203~999999996239
204~999999981517
205~999999981864
206~999999981687
207~999999981435
208~999999981595
209~999999981730
210~999999996223
211~999999981450
212~999999981487
213~999999996211
214~999999981525
215~999999981682
216~999999981581
217~999999981480
218~999999981431
219~999999981991
220~999999981805
221~999999981568
222~999999996222
223~999999981447
224~999999981702
225~999999981999
226~999999981396
227~999999981677
228~999999815342
229~999999981844
230~999999981578
231~999999981556
232~999999981693
233~999999996210
234~999999996207
235~999999996231
236~999999981860
237~999999981680
238~999999981461
239~999999996203
240~999999981697
241~999999981591
242~999999981438
243~999999981559
244~999999996204
245~999999981593
246~999999981676
247~999999996220
248~999999996202
249~999999981444
250~999999996228
251~999999981870
252~999999981582
253~999999981400
254~999999981540
255~999999981483
256~999999996205
257~999999996232
